R 1080 720
NO ./wolftex/wood.xpm
SO ./wolftex/colorstone.xpm
EA ./wolftex/greystone.xpm
WE ./wolftex/greystone.xpm
S ./wolftex/SPRITE.xpm
F 122,122,122

C                                                                                               255,200,160
11111111111111111
10000000000000001
10200000200000201
10000000000000001
10002000200020001
10000000000000001
10202020N02020201
10000000000000001
10002000200200001
10000000000000001
10200000200002001
10000000000000001
11111111111111111
