R 1280 720

NO ./etc/eagle.xpm
WE ./etc/wood.xpm
SO ./etc/greystone.xpm
EA ./etc/colorstone.xpm
S  ./etc/SPRITE.xpm

C  135,0,100
F  150,0,0

1111111111
100S000001
1000000001
1110111111
