R 1280 720


NO ./etc/eagle.xpm
WE ./etc/wood.xpm
SO ./etc/greystone.xpm
EA ./etc/colorstone.xpm
S  ./etc/SPRITE.xpm

C  135,206,235
F  244,164,96

11111111111111111111111111
10000000010000000000000001
10011111010010000000000001
10010001010010002000000001
10010101010010000000000001
100101010100100000N0000001
10010101010010000000000001
10010101010010000000000001
10010101010010002000000001
10010101010010000000000001
10110101010010000000000001
10000111000010000000000001
11111111111111111111111111
