R  1280 720
NO ./etc/eagle.xpm
WE ./etc/wood.xpm
SO ./etc/greystone.xpm
EA ./etc/colorstone.xpm
S  ./etc/SPRITE.xpm

C  135,150,100
F  150,100,100

11111111111111111
10000000000000001
10000000000000001
10000200002000001
10000000000000001
100000000S0000001
10000000000000001
10000020000000001
10000000000000001
10000000002000001
10000000000000001
11111111111111111
