R 1920 1080


NO ./etc/eagle.xpm
WE ./etc/greystone.xpm
SO ./etc/redbrick.xpm
EA ./etc/wood.xpm
S  ./etc/SPRITE.xpm

C  135,206,235
F  244,164,96

111111111111111
111111111111111
110000000000011
110000000000011
110000000000011
110000000000011
110000000000011
110000000000011
110000000000011
110000000000011
1100N0000000011
110000000000011
110000000000011
111111111111111
111111111111111

