R 1920 1080 


NO ./etc/NO.xpm
WE ./etc/WE.xpm
SO ./etc/SO.xpm
EA ./etc/EA.xpm
S  ./etc/SPRITE.xpm

C  135,206,235
F  244,164,96

1111111111111
1000000000001
1000000000001
1000000000001
1000000000001
1000000000001
1000000000001
1000000000001
1000000000001
100N000000001
1000000000001
1000000000001
1111111111111

