R 1000 800


NO ./etc/NO.xpm
NO ./etc/NO.xpm
WE ./etc/WE.xpm
SO ./etc/SO.xpm
EA ./etc/EA.xpm
S  ./etc/SPRITE.xpm

C  135,206,235
F  244,164,96

1111111111
10002000W1
1000000001
1000100001
1000000001
1111111111
